wwwwwwwwwwwwwwwwwwwwwwwwwwwwww
w                            w                                    
w                            w  
wbbibbbbbbbbbb              bw
wb  bb  bb  bb          bbbbbw                    
wbbbbbbbbbbbbb    ww      bbbw
wbbbbbbbbbbbb      bbbbbbb   w
wbbbbbbbbbb      bbbbbbb   bbw
wbbbbbbbbbbb      bbbbbbb   bw
wbbbbbbbbbbbb      bbbbbbb   w
w                            w                              
w                            w                                  
w                            w                                    
wbbbbbbbbbbbbb              bw                                 
wb  bb  bb  bb          bbbbbw
wbbbbbbbbbbbbb          bbbbbw        
w0bbbbbbbbbbbb          bbbbbw
w                            w
w                            w
w                            w
w                            w
w                            w
w                            w
w                            w
w                            w
w                            w
w                            w
w                            w
w                            w
w                            w
wwwwwwwwwwwwwwwwwwwwwwwwwwwwww
