         wwwwddddwwww         
         w          w                                             
         w          w          
         w          w         
         w          w                             
         w          w         
         w          w         
         w          w         
         w          w         
         w          w         
         w          w                                       
wwwwwwwwww          w                                           
w                   w                                             
d                   w                                          
d                   w         
d                   w                 
d                   w         
w                   w         
w                   w         
wwwwwwwwww          w         
         w          w         
         w          w         
         w          w         
         w          w         
         w          w         
         w          w         
         w          w         
         w          w         
         w          w         
         w          w          
         wwwwddddwwww         
