         wwwwddddwwww         
         w          w                                             
         w          w          
         w          w         
         w          w                             
         w          w         
         w          w         
         w          w         
         w          w         
         w          w         
         w          w                                       
wwwwwwwwww          wwwwwwwwww                                  
w                            w                                    
d                            d                                 
d                            d
d                            d        
d                            d
w                            w
w                            w
wwwwwwwwww          wwwwwwwwww
         w          w         
         w          w         
         w          w         
         w          w         
         w          w         
         w          w         
         w          w         
         w          w         
         w          w         
         w          w          
         wwwwddddwwww         
