wwwwwwwwwwwwwddddwwwwwwwwwwwww
w                            w                                    
w                            w 
w                            w
w                            w                    
w                            w
w                            w
w                            w
w                            w
w                            w
w                            w                              
w                            w                                  
w                            w                                    
w                            d                                 
w                            d
w                            d        
w                            d
w                            w
w                            w
w                            w
w                            w
w                            w
w                            w
w                            w
w                            w
w                            w
w                            w
w                            w
w                            w
w                            w
wwwwwwwwwwwwwddddwwwwwwwwwwwww
