wwwwwwwwwwwwwwwwwwwwwwwwwwwwww
w                            w                                    
w                            w 
w                            w
w                            w                    
w                            w
w                            w
w                            w
w                            w
w                            w
w                            w                              
w                            w                                  
w                            w                                    
d                            d                                 
d                            d
d                            d        
d                            d
w                            w
w                            w
w                            w
w                            w
w                            w
w                            w
w                            w
w                            w
w                            w
w                            w
w                            w
w                            w
w                            w
wwwwwwwwwwwwwwwwwwwwwwwwwwwwww
