wwwwwwwwwwwwwddddwwwwwwwwwwwww
w                            w                                    
w                            w 
w                            w
w                            w                    
w                            w
w                            w
w                            w
w                            w
w                            w
w                            w                              
w                            w                                  
w                            w                                    
w                            w                               
w                            w
w                            w        
w                            w
w                            w
w                            w
w                            w
w                            w
w                            w
w                            w
w                            w
w                            w
w                            w
w                            w
w                            w
w                            w
w                            w
wwwwwwwwwwwwwddddwwwwwwwwwwwww
